0 1 0 2 3 4 3 5 0 1
 2 3 4 3 4 3 4 3 4 3
 5 6 0 6 0 1 6 0 1 1
 6 0 6 6 6 1 0 6 1 2
 3 5 1 7 8 8 8 8 8 8
 8 8 8 8 8 8 8 8 8 8
 8 8 8 8 8 8 8 8 8 8
 8 8 8 8 8 8 8 8 8 8
 8 9 9 9 9 9 9 9 9 9
 9 9 9 9 9 9 9 9 9 10
 6 6 6 6 1 6 6 11 12 13
 12 14 6 6 11 12 13 12 13 12
 13 12 13 12 14 0 1 6 6 6
 0 1 0 0 6 6 1 1 6 0
 6 6 6 11 12 14 0 15 15 15
 15 15 15 15 15 15 15 15 15 15
 15 15 15 16 16 16 16 16 15 15
 15 15 15 16 16 16 16 16 16 16
 16 16 15 15 16 17 8 8 8 8
 8 8 8 8 8 8 8 8 8 8
 8 8 8 8 18 19 20 21 6 22
 23 24 22 24 22 22 23 23 23 24
 22 23 23 24 24 22 23 23 22 23
 23 24 6 1 6 6 22 23 23 23
 24 6 6 6 6 22 23 23 23 23
 24 25 25 25 25 25 25 25 25 25
 25 25 25 25 25 25 25 15 15 15
 15 15 25 25 25 25 25 16 15 15
 16 16 16 16 16 15 25 25 16 15
 15 16 16 16 16 16 16 16 16 16
 16 16 15 15 15 15 16 16 26 27
 28 29 6 25 25 25 25 25 25 25
 25 25 25 25 25 25 25 25 25 25
 25 25 25 25 25 25 30 31 31 32
 25 25 25 25 25 30 31 31 32 25
 25 25 25 25 25 25 25 33 33 33
 33 33 33 33 33 33 33 33 33 33
 25 25 25 25 25 25 25 33 33 33
 33 15 25 25 16 15 15 16 16 25
 25 33 16 25 25 15 15 15 15 16
 16 16 16 16 15 15 25 25 25 25
 15 16 34 35 28 29 36 33 33 33
 33 25 25 25 33 33 33 33 33 25
 25 33 33 33 33 33 37 37 37 33
 36 36 36 36 33 33 33 33 33 36
 36 36 36 33 33 33 33 33 33 33
 33 33 33 37 37 33 25 25 25 25
 25 25 25 33 33 33 33 33 33 33
 33 33 37 33 25 25 25 33 16 25
 25 15 15 33 33 37 16 33 25 25
 25 25 25 16 16 15 15 16 25 25
 33 37 37 37 25 15 38 39 40 41
 42 43 43 43 44 33 33 33 25 33
 33 25 45 33 33 46 43 44 33 33
 47 47 47 46 48 36 36 42 43 43
 43 43 43 48 36 36 42 43 44 33
 33 33 33 33 33 33 33 47 47 45
 33 33 33 33 33 33 33 33 33 33
 25 25 33 25 25 33 47 33 33 33
 33 33 16 33 25 25 25 33 33 47
 16 33 33 33 33 33 33 15 16 25
 25 16 33 33 33 47 47 33 33 25
 49 50 28 29 36 36 36 36 51 52
 52 52 53 54 54 55 56 52 52 57
 36 51 53 54 54 55 52 57 36 36
 36 36 36 36 36 36 36 36 36 36
 36 36 51 52 52 52 52 53 54 54
 54 55 52 56 52 52 52 53 54 58
 25 25 25 25 33 33 33 33 33 33
 33 33 33 33 33 33 16 25 33 33
 33 33 25 33 16 33 33 33 33 25
 25 25 16 33 33 16 33 33 25 25
 25 25 25 25 25 59 60 29 