42 15
28,28,28,28,28,28,28,28,28,28,28,28,28,28,28,28,28,28,28,28,28,28,28,28,28,28,28,28,28,28,28,28,28,28,28,28,28,28,28,28,28,28,
28,28,28,28,28,28,28,28,28,28,28,28,28,28,28,28,28,28,28,28,28,28,28,28,28,28,28,28,28,28,28,28,28,28,28,28,28,28,28,28,28,28,
28,28,28,28,16,17,17,18,28,28,28,28,28,28,28,28,28,28,28,28,28,28,28,28,28,28,28,28,28,28,28,28,28,28,28,16,17,18,28,28,28,28,
28,28,28,28,22,23,23,24,28,28,28,28,28,28,28,28,28,28,28,28,28,28,28,28,16,17,18,28,28,28,28,28,28,28,28,22,23,24,28,28,28,28,
28,28,28,28,28,28,28,28,28,28,28,28,28,28,28,28,28,28,28,28,28,28,28,28,22,23,24,28,28,28,28,28,28,28,28,28,28,28,28,28,28,28,
28,28,28,28,28,28,28,28,28,28,28,28,28,28,28,28,28,28,28,28,28,28,28,28,28,28,28,28,28,28,28,28,28,28,28,28,28,28,28,28,28,28,
28,28,28,28,28,28,28,28,28,28,28,28,28,28,28,28,28,28,28,28,28,28,28,28,28,28,28,28,28,28,28,28,28,28,28,28,28,28,28,28,28,28,
28,28,28,28,28,28,28,28,28,28,28,28,28,28,28,28,28,28,28,28,28,28,28,28,28,28,28,28,28,28,28,28,28,28,28,28,28,28,28,28,28,28,
28,28,28,28,28,28,28,28,28,28,28,28,28,28,28,28,28,28,28,28,28,28,28,28,28,28,28,9,9,9,28,28,28,28,28,28,28,28,28,28,28,28,
28,28,28,28,28,28,28,28,28,28,28,28,28,28,28,28,28,28,28,28,28,28,28,28,28,28,28,3,4,5,28,28,28,28,28,28,28,28,28,28,28,28,
28,28,28,28,28,28,28,28,28,28,28,28,28,28,28,28,28,28,14,28,28,28,28,28,28,28,9,6,6,6,9,28,28,28,28,28,28,28,28,28,28,28,
28,28,28,28,28,28,28,28,28,28,28,28,28,28,28,28,28,13,19,15,28,28,28,28,28,28,4,4,7,4,4,28,28,14,28,28,28,28,28,28,28,28,
28,28,28,28,28,28,28,28,28,28,28,28,28,28,28,28,13,19,20,21,15,28,28,28,28,28,4,4,8,4,4,27,13,19,15,28,28,28,28,25,26,27,
1,1,1,1,1,1,1,1,1,1,1,1,1,1,1,1,1,1,1,1,1,1,1,1,1,1,1,1,1,1,1,1,1,1,1,1,1,1,1,1,1,1,
1,1,1,1,1,1,1,1,1,1,1,1,1,1,1,1,1,1,1,1,1,1,1,1,1,1,1,1,1,1,1,1,1,1,1,1,1,1,1,1,1,1